0000000000000000000000000000
0000400000000000000000000000
1111111211111110000000000000
0000000233333333330000040000
0000000200001120001111111211
0000000200001120000000000200
0000000200001120000000400200
1121111100001111111121111111
0020000000000000000020000000
0020000000000000000020000000
1111111112111111111120000000
0000000002000000000020000000
0000000402333333333320004000
0000211111100000000011111112
0000200000006000004000000002
1111111111111111111111111111
5555555555555555555555555555
