0000000000000000000000000000
0000500000000000000000000000
1111111311111110000000000000
0000000344444444440000050000
0000000300001130001111111311
0000000300001130000000000300
0000000300001130000000500300
1131111100001111111131111111
0030000000000000000030000000
0030000000000000000030000000
1111111113111111111130000000
0000000003000000000030000000
0000000503444444444430005000
0000311111100000000011111113
0000300000000000005000000003
1111111111111111111111111111
6666666666666666666666666666